%%%E%%%%%%%%%%%%
%           %%%%
% % O       %%%%
% %     K      %
% % K          %
% %%     K   O %
% %% K         %
% % O  K       %
% %      K   %%%
% %  %%%   %%%%%
  %%%%%%%%%%%%%%
%%%%%%%%%%%%%%%%