%%A%%%%%%%%%%%%%
%% %%%% %%%%%%%%
%% %%%%K%%%%%%%%
%        %%%%%%%
%              %
% O%%%%%%%%%K%%%
%     S%%%%%%%%%
%  %%%%%%%%%%%%%
%  %%%%%%%%%%%%%
%             %%
%%%%K         %%
%%%%%%%E%%%%%%%%
